+----------+                                      
|          |                 +-------------+      
|  @       +-----------------+             |      
|                                 P    **  |      
|          +-----------------+         *   |      
|          |                 |             |      
|    W     |                 |             |      
+----------+                 |             |      
                             |  M          |      
                             +-------------+      
